// largura e comprimento
32 16
// Alturas
3 3 2 2 1 1 1 1 1 1 1 2 2 2 1 1 
2 2 2 1 1 0 0 0 1 1 1 1 1 1 1 1
2 1 1 1 0 0 0 0 0 0 0 1 1 1 1 1
0 0 0 0 0 0 0 0 0 0 0 0 0 1 0 0
0 0 0 0 0 1 1 1 1 0 0 0 0 1 0 0
0 0 0 0 1 1 2 1 1 1 1 0 0 1 0 0
0 0 0 0 1 2 2 2 2 1 1 0 0 1 0 0
0 0 0 1 1 2 3 3 2 2 1 1 1 1 1 1 
0 0 2 1 1 2 3 3 3 2 2 1 1 1 1 2 
0 0 0 1 1 1 2 2 2 2 1 2 1 1 1 2 
0 0 0 0 1 1 1 2 2 2 1 2 1 1 2 2
0 0 0 0 0 0 1 1 2 1 1 2 1 1 2 2
0 0 0 0 0 0 0 0 1 1 1 1 1 2 3 3
0 0 0 0 0 0 0 0 0 1 1 1 2 2 3 4
0 0 0 0 0 0 0 0 0 1 1 1 2 2 3 4
0 0 0 0 0 0 0 0 1 1 1 1 1 2 2 3
3 3 2 2 1 1 1 1 1 1 1 1 2 2 1 2
2 2 2 1 1 0 0 0 1 1 1 1 1 1 1 2
2 1 1 1 0 0 0 0 0 0 0 1 1 1 1 1
0 0 0 0 0 0 0 0 0 0 0 0 0 1 0 0
0 0 0 0 0 1 1 1 1 0 0 0 0 1 0 0
0 0 0 0 1 1 2 1 1 1 1 0 0 1 0 0
0 0 0 0 1 2 2 2 2 1 1 0 0 1 0 0
0 0 0 1 1 2 3 3 2 2 1 1 1 1 1 1 
0 0 2 1 1 2 3 3 3 2 2 1 1 1 1 2 
0 0 0 1 1 1 2 2 2 2 1 2 1 1 1 1 
0 0 0 0 1 1 1 2 2 2 1 2 1 1 1 1
0 0 0 0 0 0 1 1 2 1 1 2 1 1 1 0
0 0 0 0 0 0 0 0 1 1 1 1 1 1 0 0
0 0 0 0 0 0 0 0 0 1 1 1 1 0 0 0
0 0 0 0 0 0 0 0 0 0 1 1 0 0 0 0
0 0 0 0 0 0 0 0 0 0 0 0 0 0 0 0
// Modificadores
15 15 15 15 15 15 15 15 15 15 15 15 15 15 15 15
15 15 15 15 15 15 15 15 15 15 15 15 15 15 15 15
15 15 15 15 15 15 15 15 15 15 15 15 15 15 15 15
15 15 15 15 15 15 15 15 15 15 15 15 15 15 15 15
15 15 15 15 15 15 15 15 15 15 15 15 15 15 15 15
15 15 15 15 15 15 15 15 15 15 15 15 15 15 15 15
15 15 15 15 15 15 15 15 15 15 15 15 15 15 15 15
15 15 15 15 15 15 15 15 15 15 15 15 15 15 15 15
15 15 15 15 15 15 15 15 15 15 15 15 15 15 15 15
15 15 15 15 15 15 15 15 15 15 15 15 15 15 15 15
15 15 15 15 15 15 15 15 15 15 15 15 15 15 15 15
15 15 15 15 15 15 15 15 15 15 15 15 15 15 15 15
15 15 15 15 15 15 15 15 15 15 15 15 15 15 15 15
15 15 15 15 15 15 15 15 15 15 15 15 15 15 15 15
15 15 15 15 15 15 15 15 15 15 15 15 15 15 15 15
15 15 15 15 15 15 15 15 15 15 15 15 15 15 15 15
15 15 15 15 15 15 15 15 15 15 15 15 15 15 15 15
15 15 15 15 15 15 15 15 15 15 15 15 15 15 15 15
15 15 15 15 15 15 15 15 15 15 15 15 15 15 15 15
15 15 15 15 15 15 15 15 15 15 15 15 15 15 15 15
15 15 15 15 15 15 15 15 15 15 15 15 15 15 15 15
15 15 15 15 15 15 15 15 15 15 15 15 15 15 15 15
15 15 15 15 15 15 15 15 15 15 15 15 15 15 15 15
15 15 15 15 15 15 15 15 15 15 15 15 15 15 15 15
15 15 15 15 15 15 15 15 15 15 15 15 15 15 15 15
15 15 15 15 15 15 15 15 15 15 15 15 15 15 15 15
15 15 15 15 15 15 15 15 15 15 15 15 15 15 15 15
15 15 15 15 15 15 15 15 15 15 15 15 15 15 15 15
15 15 15 15 15 15 15 15 15 15 15 15 15 15 15 15
15 15 15 15 15 15 15 15 15 15 15 15 15 15 15 15
15 15 15 15 15 15 15 15 15 15 15 15 15 15 15 15
15 15 15 15 15 15 15 15 15 15 15 15 15 15 15 15
// Camada de texturas 1
2 2 2 2 3 3 3 3 3 3 3 2 2 2 2 2
2 2 2 3 3 0 0 0 3 3 3 3 3 2 2 2
2 3 3 3 0 0 0 0 0 0 0 3 1 1 1 3
0 0 0 0 0 0 0 0 0 0 0 0 0 1 0 0
0 0 0 0 0 3 3 3 3 0 0 0 0 1 0 0
0 0 0 0 3 3 2 3 3 3 3 0 0 1 0 0
0 0 0 0 3 2 2 2 2 3 3 0 0 1 0 0
0 0 0 3 3 2 2 2 2 2 3 3 1 1 1 3 
0 0 2 3 3 2 2 2 2 2 2 3 3 3 3 2 
0 0 0 3 3 3 2 2 2 2 3 2 3 3 3 3 
0 0 0 0 3 3 3 2 2 2 3 2 3 3 3 3
0 0 0 0 0 0 3 3 2 3 3 2 3 3 3 3
0 0 0 0 0 0 0 0 3 3 3 3 3 3 3 3
0 0 0 0 0 0 0 0 0 3 3 3 3 3 3 3
0 0 0 0 0 0 0 0 0 3 3 3 2 3 3 3
0 0 0 0 0 0 0 0 3 3 3 3 2 2 2 2
2 2 2 2 3 3 3 3 3 3 3 2 2 2 2 2
2 2 2 3 3 0 0 0 3 3 3 3 3 2 2 2
2 3 3 3 0 0 0 0 0 0 0 3 1 1 1 3
0 0 0 0 0 0 0 0 0 0 0 0 0 1 0 0
0 0 0 0 0 3 3 3 3 0 0 0 0 1 0 0
0 0 0 0 3 3 2 3 3 3 3 0 0 1 0 0
0 0 0 0 3 2 2 2 2 3 3 0 0 1 0 0
0 0 0 3 3 2 2 2 2 2 3 3 1 1 1 3 
0 0 2 3 3 2 2 2 2 2 2 3 3 3 3 2 
0 0 0 3 3 3 2 2 2 2 3 2 3 3 3 3 
0 0 0 0 3 3 3 2 2 2 3 2 3 3 3 3
0 0 0 0 0 0 3 3 2 3 3 2 3 3 3 0
0 0 0 0 0 0 0 0 3 3 3 3 3 3 0 0
0 0 0 0 0 0 0 0 0 3 3 3 3 0 0 0
0 0 0 0 0 0 0 0 0 0 3 3 0 0 0 0
0 0 0 0 0 0 0 0 0 0 0 0 0 0 0 0
// Texturas das paredes
1 1 1 1 1 1 1 1 1 1 1 1 1 1 1 1
1 1 1 1 1 0 0 0 1 1 1 1 1 1 1 1
1 1 1 1 0 0 0 0 0 0 0 1 1 1 1 1
0 0 0 0 0 0 0 0 0 0 0 0 0 1 0 0
0 0 0 0 0 1 1 1 1 0 0 0 0 1 0 0
0 0 0 0 1 1 1 1 1 1 1 0 0 1 0 0
0 0 0 0 1 1 1 1 1 1 1 0 0 1 0 0
0 0 0 1 1 1 1 1 1 1 1 1 1 1 1 1 
0 0 1 1 1 1 1 1 1 1 1 1 1 1 1 1 
0 0 0 1 1 1 1 1 1 1 1 1 1 1 1 1 
0 0 0 0 1 1 1 1 1 1 1 1 1 1 1 1
0 0 0 0 0 0 1 1 1 1 1 1 1 1 1 1
0 0 0 0 0 0 0 0 1 1 1 1 1 1 1 1
0 0 0 0 0 0 0 0 0 1 1 1 1 1 1 1
0 0 0 0 0 0 0 0 0 1 1 1 1 1 1 1
0 0 0 0 0 0 0 0 1 1 1 1 1 1 1 1
1 1 1 1 1 1 1 1 1 1 1 1 1 1 1 1
1 1 1 1 1 0 0 0 1 1 1 1 1 1 1 1
1 1 1 1 0 0 0 0 0 0 0 1 1 1 1 1
0 0 0 0 0 0 0 0 0 0 0 0 0 1 0 0
0 0 0 0 0 1 1 1 1 0 0 0 0 1 0 0
0 0 0 0 1 1 1 1 1 1 1 0 0 1 0 0
0 0 0 0 1 1 1 1 1 1 1 0 0 1 0 0
0 0 0 1 1 1 1 1 1 1 1 1 1 1 1 1 
0 0 1 1 1 1 1 1 1 1 1 1 1 1 1 1 
0 0 0 1 1 1 1 1 1 1 1 1 1 1 1 1 
0 0 0 0 1 1 1 1 1 1 1 1 1 1 1 1
0 0 0 0 0 0 1 1 1 1 1 1 1 1 1 0
0 0 0 0 0 0 0 0 1 1 1 1 1 1 0 0
0 0 0 0 0 0 0 0 0 1 1 1 1 0 0 0
0 0 0 0 0 0 0 0 0 0 1 1 0 0 0 0
0 0 0 0 0 0 0 0 0 0 0 0 0 0 0 0
// Decorações
3
16 10 res/models/diamante.ms3d -1 0.5 1.55 0.0 0.0
10 5 res/models/diamante.ms3d -1 0.5 1.05 0.0 0.0
5 15 res/models/diamante.ms3d -1 0.5 0.0 1.25 0.0