# Dimensions
32 32
# Heights
1 1 1 1 1 1 1 2 2 7 6 5 5 7 5 8 5 4 6 7 8 7 7 6 4 5 4 4 6 6 7 8 
1 1 1 1 1 2 2 2 5 7 5 8 5 4 6 7 8 7 7 6 4 5 4 4 6 6 7 8 4 7 8 9 
1 1 1 1 2 2 3 3 7 7 6 4 5 4 4 6 6 7 8 4 7 8 9 7 7 6 4 5 4 4 6 6
1 1 1 1 2 3 3 3 3 3 3 3 3 3 3 3 3 3 3 3 3 3 3 3 3 3 3 3 3 3 3 3 
1 1 1 1 2 3 3 3 3 3 3 3 3 3 3 3 3 3 3 3 3 3 3 3 3 3 3 3 3 3 3 3 
1 1 1 1 2 2 3 3 8 5 7 5 8 9 9 6 3 3 8 9 5 4 9 3 3 8 9 5 4 9 7 8 
1 1 1 1 1 2 3 3 7 4 6 6 4 7 9 5 3 3 5 6 7 7 8 3 3 5 9 9 7 8 8 10 
1 1 1 1 1 2 3 3 8 6 4 2 4 6 6 7 3 3 4 5 8 4 7 3 3 7 7 9 4 5 6 10
1 1 1 1 2 2 3 3 7 5 7 4 6 5 6 5 3 3 7 5 4 7 6 3 3 7 8 6 6 5 6 10
1 1 1 1 2 3 3 3 3 3 3 3 3 3 3 3 3 3 3 3 3 3 3 3 3 3 3 3 3 3 3 3 
1 1 1 1 2 3 3 3 3 3 3 3 3 3 3 3 3 3 3 3 3 3 3 3 3 3 3 3 3 3 3 3 
1 1 1 1 2 2 3 3 7 6 8 8 7 7 8 7 7 6 4 5 4 4 6 3 3 8 4 7 8 9 6 7 
1 1 1 1 1 2 2 3 6 4 7 7 8 5 4 6 7 8 7 7 6 4 5 3 3 6 6 7 8 4 7 8
1 1 1 1 1 1 2 2 3 3 3 3 3 3 3 3 3 3 3 6 5 6 4 3 3 6 4 5 4 4 6 6
1 1 1 1 1 1 1 2 2 2 2 2 2 2 2 2 2 2 2 3 4 5 7 3 3 5 8 7 7 6 4 5
1 1 1 1 1 1 1 1 1 1 1 1 1 1 1 1 1 1 2 2 3 7 6 3 3 7 8 6 6 5 6 10
1 1 1 1 1 1 1 1 1 1 1 1 1 1 1 1 1 1 1 2 3 3 3 3 3 3 3 3 3 3 3 3 
1 1 1 1 2 2 1 2 2 2 2 2 2 2 1 1 1 1 1 2 3 3 3 3 3 3 3 3 3 3 3 3 
1 1 1 2 2 3 1 3 3 3 3 3 3 2 2 2 2 2 2 2 3 6 5 3 3 6 8 7 7 6 4 5
1 1 2 2 3 3 1 3 3 3 3 3 3 3 3 5 6 8 5 6 7 7 5 3 3 7 5 4 4 6 6 6
1 1 2 2 3 1 1 3 3 3 3 3 3 3 3 7 8 4 7 8 9 4 6 3 3 6 6 6 7 8 4 7 
1 1 1 2 3 1 1 3 3 3 3 3 3 3 3 4 6 7 4 8 9 8 9 3 3 4 5 7 5 7 4 6 
1 1 1 2 2 3 1 3 3 3 3 3 3 3 3 3 3 3 3 3 3 3 3 3 3 3 3 3 3 3 3 3 
1 1 1 1 2 3 1 3 3 3 3 3 3 3 3 3 3 3 3 3 3 3 3 3 3 3 3 3 3 3 3 3 
1 1 1 1 2 2 1 3 3 3 3 3 3 3 3 5 6 7 4 8 9 7 6 3 3 9 8 6 5 3 7 8
1 1 1 1 1 2 1 3 3 3 3 3 3 3 3 9 5 7 5 8 5 7 4 3 3 6 9 7 5 9 7 8
1 1 1 1 1 1 1 3 3 3 3 3 3 3 3 6 6 5 9 5 6 6 6 3 3 7 5 7 8 9 7 5
1 1 1 1 1 2 1 3 3 3 3 3 3 3 3 5 7 5 8 7 7 6 7 3 3 4 6 8 9 6 7 8
1 1 1 1 1 1 1 2 3 3 3 3 3 3 3 3 3 3 3 3 3 3 3 3 3 3 3 3 3 3 3 3 
1 1 1 1 1 1 1 2 3 3 3 3 3 3 3 3 3 3 3 3 3 3 3 3 3 3 3 3 3 3 3 3 
1 1 1 1 1 1 1 2 3 7 9 6 5 3 3 6 5 6 7 8 9 8 9 3 3 7 6 8 5 5 7 5
1 1 1 1 1 1 1 2 3 6 7 8 6 3 3 6 7 5 7 8 9 7 7 3 3 5 7 8 6 7 5 7
# Modifiers
-1 -1 -1 -1 -1 -1 -1 -1  -1 -1 -1 -1 -1 -1 -1 -1 -1 -1 -1 -1 -1 -1 -1 -1 -1 -1 -1 -1 -1 -1 -1 -1 
-1 -1 -1 -1 -1 -1 -1 -1 -1 -1 -1 -1 -1 -1 -1 -1 -1 -1 -1 -1 -1 -1 -1 -1 -1 -1 -1 -1 -1 -1 -1 -1 
-1 -1 -1 -1 -1 -1 7 8 -1 -1 -1 -1 -1 -1 -1 -1 -1 -1 -1 -1 -1 -1 -1 -1 -1 -1 -1 -1 -1 -1 -1 -1
-1 -1 -1 -1 -1 7 12 13 2 2 2 2 2 2 2 2 2 2 2 2 2 2 2 2 2 2 2 2 2 2 2 2 
-1 -1 -1 -1 -1 6 11 10 4 4 4 4 4 4 4 4 11 10 4 4 4 4 4 11 10 4 4 4 4 4 4 4
-1 -1 -1 -1 -1 -1 6 9 -1 -1 -1 -1 -1 -1 -1 -1 5 3 -1 -1 -1 -1 -1 5 3 -1 -1 -1 -1 -1 -1 -1 
-1 -1 -1 -1 -1 -1 -1 -1 -1 -1 -1 -1 -1 -1 -1 -1 5 3 -1 -1 -1 -1 -1 5 3 -1 -1 -1 -1 -1 -1 -1
-1 -1 -1 -1 -1 -1 -1 -1 -1 -1 -1 -1 -1 -1 -1 -1 5 3 -1 -1 -1 -1 -1 5 3 -1 -1 -1 -1 -1 -1 -1 
-1 -1 -1 -1 -1 -1 -1 -1 -1 -1 -1 -1 -1 -1 -1 -1 5 3 -1 -1 -1 -1 -1 5 3 -1 -1 -1 -1 -1 -1 -1 
-1 -1 -1 -1 -1 -1 -1 -1 7 2 2 2 2 2 2 2 12 13 2 2 2 2 2 12 13 2 2 2 2 2 2 2
-1 -1 -1 -1 -1 -1 -1 -1 6 4 4 4 4 4 4 4 4 4 4 4 4 4 4 11 10 4 4 4 4 4 4 4 
-1 -1 -1 -1 -1 -1 -1 -1 -1 -1 -1 -1 -1 -1 -1 -1 -1 -1 -1 -1 -1 -1 -1 5 3 -1 -1 -1 -1 -1 -1 -1 
-1 -1 -1 -1 -1 -1 -1 -1 -1 -1 -1 -1 -1 -1 -1 -1 -1 -1 -1 -1 -1 -1 -1 5 3 -1 -1 -1 -1 -1 -1 -1 
-1 -1 -1 -1 -1 -1 -1 -1 -1 -1 -1 -1 -1 -1 -1 -1 -1 -1 -1 -1 -1 -1 -1 5 3 -1 -1 -1 -1 -1 -1 -1 
-1 -1 -1 -1 -1 -1 -1 -1 -1 -1 -1 -1 -1 -1 -1 -1 -1 -1 -1 -1 -1 -1 -1 5 3 -1 -1 -1 -1 -1 -1 -1 
-1 -1 -1 -1 -1 -1 -1 -1 -1 -1 -1 -1 -1 -1 -1 -1 -1 -1 -1 -1 -1 -1 -1 5 3 -1 -1 -1 -1 -1 -1 -1 
-1 -1 -1 -1 -1 -1 -1 -1 -1 -1 -1 -1 -1 -1 -1 -1 -1 -1 -1 -1 -1 -1 -1 5 13 2 2 2 2 2 2 2 
-1 -1 -1 -1 -1 -1 -1 -1 -1 -1 -1 -1 -1 -1 -1 -1 -1 -1 -1 -1 -1 -1 -1 5 10 4 4 4 4 4 4 4 
-1 -1 -1 -1 -1 -1 -1 -1 -1 -1 -1 -1 -1 -1 -1 -1 -1 -1 -1 -1 -1 -1 -1 5 3 -1 -1 -1 -1 -1 -1 -1 
-1 -1 -1 -1 -1 -1 -1 -1 -1 -1 -1 -1 -1 -1 -1 -1 -1 -1 -1 -1 -1 -1 -1 5 3 -1 -1 -1 -1 -1 -1 -1 
-1 -1 -1 -1 -1 -1 -1 -1 -1 -1 -1 -1 -1 -1 -1 -1 -1 -1 -1 -1 -1 -1 -1 5 3 -1 -1 -1 -1 -1 -1 -1 
-1 -1 -1 -1 -1 -1 -1 -1 -1 -1 -1 -1 -1 -1 -1 -1 -1 -1 -1 -1 -1 -1 -1 5 3 -1 -1 -1 -1 -1 -1 -1 
-1 -1 -1 -1 -1 -1 -1 7 2 2 2 2 2 2 2 2 2 2 2 2 2 2 2 12 13 2 2 2 2 2 2 2 
-1 -1 -1 -1 -1 -1 -1 6 4 4 4 4 4 11 10 4 4 4 4 4 4 4 4 11 10 4 4 4 4 4 4 4 
-1 -1 -1 -1 -1 -1 -1 -1 -1 -1 -1 -1 -1 5 3 -1 -1 -1 -1 -1 -1 -1 -1 5 3 -1 -1 -1 -1 -1 -1 -1 
-1 -1 -1 -1 -1 -1 -1 -1 -1 -1 -1 -1 -1 5 3 -1 -1 -1 -1 -1 -1 -1 -1 5 3 -1 -1 -1 -1 -1 -1 -1 
-1 -1 -1 -1 -1 -1 -1 -1 -1 -1 -1 -1 -1 5 3 -1 -1 -1 -1 -1 -1 -1 -1 5 3 -1 -1 -1 -1 -1 -1 -1 
-1 -1 -1 -1 -1 -1 -1 -1 -1 -1 -1 -1 -1 5 3 -1 -1 -1 -1 -1 -1 -1 -1 5 3 -1 -1 -1 -1 -1 -1 -1  
-1 -1 -1 -1 -1 -1 -1 -1 -1 7 2 2 2 12 13 2 2 2 2 2 2 2 2 12 13 2 2 2 2 2 2 2 
-1 -1 -1 -1 -1 -1 -1 -1 -1 6 4 4 4 11 10 4 4 4 4 4 4 4 4 11 10 4 4 4 4 4 4 4 
-1 -1 -1 -1 -1 -1 -1 -1 -1 -1 -1 -1 -1 5 3 -1 -1 -1 -1 -1 -1 -1 -1 5 3 -1 -1 -1 -1 -1 -1 -1 
-1 -1 -1 -1 -1 -1 -1 -1 -1 -1 -1 -1 -1 5 3 -1 -1 -1 -1 -1 -1 -1 -1 5 3 -1 -1 -1 -1 -1 -1 -1 
# Top textures
0 0 0 0 0 0 0  1  1 14 14 14 14 14 14 14 14 14 14 14 14 14 14 14 14 14 14 14 14 14 14 14 
0 0 0 0 0 1 1  1 14 14 14 14 14 14 14 14 14 14 14 14 14 14 14 14 14 14 14 14 14 14 14 14 
0 0 0 0 1 1 7  8 14 14 14 14 14 14 14 14 14 14 14 14 14 14 14 14 14 14 14 14 14 14 14 14
0 0 0 0 1 7 12 13 2 2 2 2 2 2 2 2 2 2 2 2 2 2 2 2 2 2 2 2 2 2 2 2 
0 0 0 0 1 6 11 10 4 4 4 4 4 4 4 4 11 10 4 4 4 4 4 11 10 4 4 4 4 4 4 4
0 0 0 0 1 1 6  9 14 14 14 14 14 14 14 14 5 3 14 14 14 14 14 5 3 14 14 14 14 14 14 14 
0 0 0 0 0 1 1 14 14 14 14 14 14 14 14 14 5 3 14 14 14 14 14 5 3 14 14 14 14 14 14 14
0 0 0 0 0 1 1 14 14 14 14 14 14 14 14 14 5 3 14 14 14 14 14 5 3 14 14 14 14 14 14 14 
0 0 0 0 1 1 1 14 14 14 14 14 14 14 14 14 5 3 14 14 14 14 14 5 3 14 14 14 14 14 14 14 
0 0 0 0 1 1 1 14 7 2 2 2 2 2 2 2 12 13 2 2 2 2 2 12 13 2 2 2 2 2 2 2
0 0 0 0 1 1 1 14 6 4 4 4 4 4 4 4 4 4 4 4 4 4 4 11 10 4 4 4 4 4 4 4 
0 0 0 0 1 1 1 14 14 14 14 14 14 14 14 14 14 14 14 14 14 14 14 5 3 14 14 14 14 14 14 14 
0 0 0 0 0 1 1 1 14 14 14 14 14 14 14 14 14 14 14 14 14 14 14 5 3 14 14 14 14 14 14 14 
0 0 0 0 0 0 1 1 1 1 1 1 1 1 1 1 1 1 1 14 14 14 14 5 3 14 14 14 14 14 14 14 
0 0 0 0 0 0 0 1 1 1 1 1 1 1 1 1 1 1 1 1 14 14 14 5 3 14 14 14 14 14 14 14 
0 0 0 0 0 0 0 0 0 0 0 0 0 0 0 0 0 0 1 1 1 14 14 5 3 14 14 14 14 14 14 14 
0 0 0 0 0 0 0 0 0 0 0 0 0 0 0 0 0 0 0 1 1 14 14 5 13 2 2 2 2 2 2 2 
0 0 0 0 1 1 0 1 1 1 1 1 1 1 0 0 0 0 0 1 1 14 14 5 10 4 4 4 4 4 4 4 
0 0 0 1 1 1 0 1 1 1 1 1 1 1 1 1 1 1 1 1 1 14 14 5 3 14 14 14 14 14 14 14 
0 0 1 1 1 1 0 14 14 14 14 14 14 14 14 14 14 14 14 14 14 14 14 5 3 14 14 14 14 14 14 14 
0 0 1 1 1 0 0 14 14 14 14 14 14 14 14 14 14 14 14 14 14 14 14 5 3 14 14 14 14 14 14 14 
0 0 0 1 1 0 0 14 14 14 14 14 14 14 14 14 14 14 14 14 14 14 14 5 3 14 14 14 14 14 14 14 
0 0 0 1 1 1 0 7 2 2 2 2 2 2 2 2 2 2 2 2 2 2 2 12 13 2 2 2 2 2 2 2 
0 0 0 0 1 1 0 6 4 4 4 4 4 11 10 4 4 4 4 4 4 4 4 11 10 4 4 4 4 4 4 4 
0 0 0 0 1 1 0 14 14 14 14 14 14 5 3 14 14 14 14 14 14 14 14 5 3 14 14 14 14 14 14 14 
0 0 0 0 0 1 0 14 14 14 14 14 14 5 3 14 14 14 14 14 14 14 14 5 3 14 14 14 14 14 14 14 
0 0 0 0 0 0 0 14 14 14 14 14 14 5 3 14 14 14 14 14 14 14 14 5 3 14 14 14 14 14 14 14 
0 0 0 0 0 1 0 14 14 14 14 14 14 5 3 14 14 14 14 14 14 14 14 5 3 14 14 14 14 14 14 14  
0 0 0 0 0 0 0 14 14 7 2 2 2 12 13 2 2 2 2 2 2 2 2 12 13 2 2 2 2 2 2 2 
0 0 0 0 0 0 0 14 14 6 4 4 4 11 10 4 4 4 4 4 4 4 4 11 10 4 4 4 4 4 4 4 
0 0 0 0 0 0 0 14 14 14 14 14 14 5 3 14 14 14 14 14 14 14 14 5 3 14 14 14 14 14 14 14 
0 0 0 0 0 0 0 14 14 14 14 14 14 5 3 14 14 14 14 14 14 14 14 5 3 14 14 14 14 14 14 14 
# Side textures
0 0 0 0 0 0 0 1 1  15 15 15 15 15 15 15 15 15 15 15 15 15 15 15 15 15 15 15 15 15 15 15 
0 0 0 0 0 1 1 1 15 15 15 15 15 15 15 15 15 15 15 15 15 15 15 15 15 15 15 15 15 15 15 15
0 0 0 0 1 1 1 1 15 15 15 15 15 15 15 15 15 15 15 15 15 15 15 15 15 15 15 15 15 15 15 15 
0 0 0 0 1 1 1 1 1 1 1 1 1 1 1 1 1 1 1 1 1 1 1 1 1 1 1 1 1 1 1 1 
0 0 0 0 1 1 1 1 1 1 1 1 1 1 1 1 1 1 1 1 1 1 1 1 1 1 1 1 1 1 1 1 
0 0 0 0 1 1 1 1 15 15 15 15 15 15 15 15 1 1 15 15 15 15 15 1 1 15 15 15 15 15 15 15 
0 0 0 0 0 1 1 1 15 15 15 15 15 15 15 15 1 1 15 15 15 15 15 1 1 15 15 15 15 15 15 15 
0 0 0 0 0 1 1 1 15 15 15 15 15 15 15 15 1 1 15 15 15 15 15 1 1 15 15 15 15 15 15 15 
0 0 0 0 1 1 1 1 15 15 15 15 15 15 15 15 1 1 15 15 15 15 15 1 1 15 15 15 15 15 15 15 
0 0 0 0 1 1 1 1 1 1 1 1 1 1 1 1 1 1 1 1 1 1 1 1 1 1 1 1 1 1 1 1 
0 0 0 0 1 1 1 1 1 1 1 1 1 1 1 1 1 1 1 1 1 1 1 1 1 1 1 1 1 1 1 1 
0 0 0 0 1 1 1 1 15 15 15 15 15 15 15 15 15 15 15 15 15 15 15 1 1 15 15 15 15 15 15 15 
0 0 0 0 0 1 1 1 15 15 15 15 15 15 15 15 15 15 15 15 15 15 15 1 1 15 15 15 15 15 15 15 
0 0 0 0 0 0 1 1 1 1 1 1 1 1 1 1 1 1 1 15 15 15 15 1 1 15 15 15 15 15 15 15 
0 0 0 0 0 0 0 1 1 1 1 1 1 1 1 1 1 1 1 1 15 15 15 1 1 15 15 15 15 15 15 15 
0 0 0 0 0 0 0 0 0 0 0 0 0 0 0 0 0 0 1 1 1 15 15 1 1 15 15 15 15 15 15 15 
0 0 0 0 0 0 0 0 0 0 0 0 0 0 0 0 0 0 0 1 1 1 1 1 1 1 1 1 1 1 1 1 
0 0 0 0 1 1 0 1 1 1 1 1 1 1 0 0 0 0 0 1 1 1 1 1 1 1 1 1 1 1 1 1 
0 0 0 1 1 1 0 15 15 15 15 15 15 15 15 15 15 15 15 15 15 15 15 1 1 15 15 15 15 15 15 15 
0 0 1 1 1 1 0 15 15 15 15 15 15 15 15 15 15 15 15 15 15 15 15 1 1 15 15 15 15 15 15 15 
0 0 1 1 1 0 0 15 15 15 15 15 15 15 15 15 15 15 15 15 15 15 15 1 1 15 15 15 15 15 15 15  
0 0 0 1 1 0 0 15 15 15 15 15 15 15 15 15 15 15 15 15 15 15 15 1 1 15 15 15 15 15 15 15 
0 0 0 1 1 1 0 1 1 1 1 1 1 1 1 1 1 1 1 1 1 1 1 1 1 1 1 1 1 1 1 1 
0 0 0 0 1 1 0 1 1 1 1 1 1 1 1 1 1 1 1 1 1 1 1 1 1 1 1 1 1 1 1 1 
0 0 0 0 1 1 0 15 15 15 15 15 15 1 1 15 15 15 15 15 15 15 15 1 1 15 15 15 15 15 15 15 
0 0 0 0 0 1 0 15 15 15 15 15 15 1 1 15 15 15 15 15 15 15 15 1 1 15 15 15 15 15 15 15  
0 0 0 0 0 0 0 15 15 15 15 15 15 1 1 15 15 15 15 15 15 15 15 1 1 15 15 15 15 15 15 15  
0 0 0 0 0 1 0 15 15 15 15 15 15 1 1 15 15 15 15 15 15 15 15 1 1 15 15 15 15 15 15 15 
0 0 0 0 0 0 0 15 15 1 1 1 1 1 1 1 1 1 1 1 1 1 1 1 1 1 1 1 1 1 1 1 
0 0 0 0 0 0 0 15 15 1 1 1 1 1 1 1 1 1 1 1 1 1 1 1 1 1 1 1 1 1 1 1 
0 0 0 0 0 0 0 15 15 15 15 15 15 1 1 15 15 15 15 15 15 15 15 1 1 15 15 15 15 15 15 15  
0 0 0 0 0 0 0 15 15 15 15 15 15 1 1 15 15 15 15 15 15 15 15 1 1 15 15 15 15 15 15 15 
# Decorations
0
