# Dimensions
10 10
# Heights
1 1 1 0 0 0 1 1 1 1 
1 1 1 1 1 0 0 1 1 1 
1 2 2 2 1 1 0 0 1 1 
1 2 2 1 0 0 0 0 0 0 
0 1 1 0 0 1 1 1 0 0 
0 0 0 0 1 2 2 2 1 0 
1 0 0 0 1 2 2 2 1 0 
1 1 0 0 1 2 2 1 0 0 
2 1 0 0 0 1 1 0 0 1 
2 2 1 1 0 0 0 0 1 2 
# Modifiers
15 15 15 15 15 15 15 15 15 15 
15 15 15 15 15 15 15 15 15 15 
15 15 15 15 15 15 15 15 15 15 
15 15 15 15 15 15 15 15 15 15 
15 15 15 15 15 15 15 15 15 15 
15 15 15 15 15 15 15 15 15 15 
15 15 15 15 15 15 15 15 15 15 
15 15 15 15 15 15 15 15 15 15 
15 15 15 15 15 15 15 15 15 15 
15 15 15 15 15 15 15 15 15 15 
# Top textures
3 3 3 3 3 3 3 3 3 3 
3 2 2 3 3 3 3 3 3 3 
2 2 2 2 2 2 3 3 3 3 
3 2 2 2 3 3 3 3 3 3 
3 2 2 3 3 2 2 2 3 3 
3 3 3 3 2 2 2 2 2 3 
3 3 3 3 2 2 2 2 2 3 
2 3 3 3 2 2 2 2 3 3 
2 2 3 3 3 2 2 3 3 2 
2 2 2 3 3 3 3 3 2 2 
# Side textures
1 1 1 1 1 1 1 1 1 1 
1 1 1 1 1 1 1 1 1 1 
1 1 1 1 1 1 1 1 1 1 
1 1 1 1 1 1 1 1 1 1 
1 1 1 1 1 1 1 1 1 1 
1 1 1 1 1 1 1 1 1 1 
1 1 1 1 1 1 1 1 1 1 
1 1 1 1 1 1 1 1 1 1 
1 1 1 1 1 1 1 1 1 1 
1 1 1 1 1 1 1 1 1 1 
# Decorations
0
